NO ./texture/redbrick.xpm
SO ./texture/bluestone.xpm
WE ./texture/purplestone.xpm
EA ./texture/greystone.xpm

F 186,235,52
C 52,171,235

1111111111
1000000001
1000000001
1000000001
1010001001
1000000001
10W0000001
1000000001
1000000001
1111111111

