1111111111111111111
1000000011100000001
1000000100010000001
1000001001001000001
1000010000000100001
1000100000000010001
1001000000000001001
1001000000000001001
1001000000000001001
1001000000000001001
1001000000000001001
1001000000000001001
1001000000000001001
1001000000000001001
1001000000000001001
1001000000000001001
1001000000P00001001
1001000000000001001
1001000000000001001
1001000000000001001
1001000000000001001
1001000000000001001
1001000000000001001
1010000000000000101
1100000111100000011
1100001000010000011
1100001000010000011
1111111111111111111
