0000000011100000000
0000000100010000000
0000001001001000000
0000010000000100000
0000100000000010000
0001000000000001000
0001000000000001000
0001000000000001000
0001000000000001000
0001000000000001000
0001000000000001000
0001000000000001000
0001000000000001000
0001000000000001000
0001000000000001000
0001000000000001000
0001000000000001000
0001000000000001000
0001000000000001000
0001000000000001000
0001000000000001000
0001000000000001000
0010000000000000100
0100000111100000010
0100001000010000010
0100001000010000010
0011110000001111100