111111
100001
1000001
1000001
1111111
111111
100001
1000001
1000001
1111111
111111
100001
1000001
1000001
1111111
111111
100001
1000001
1000001
1111111
111111
100001
1000001
1000001
1111111
111111
100001
1000001
1000001
1111111
111111
100001
1000001
1000001
1111111
111111
100001
1000001
1000001
1111111111111
100001
1000001
1000001
1111111111111
100001
1000001
1000001
1111111111111
100001
1000001
1000001
1111111111111
100001
1000001
1000001
1111111111111
100001
1000001
1000001
1111111111111
100001
1000001
1000001
1111111111111
100001
1000001
1000001
1111111111111
100001
1000001
1000001
1111111111111
100001
1000001
1000001
1111111111111
100001
1000001
1000001
1111111111111
111111
100001
1000001
1000001
1111111
111111
100001
1000001
1000001
1111111111111
100001
1000001
1000001
1111111
