1110111111111111
1001100111......
1111111111......
1011110011......
1001100111......
1001100111......
1111111111......
1111111111......
1111111111......
1111111111......
1111111111......
1...............
1...............
