111111
100001
1000001
1000001
1111111