NO ./texture/redbrick.xpm
SO ./texture/bluestone.xpm
WE ./texture/greystone.xpm
EA ./texture/purplestone.xpm
F 33,84,24
C 28,28,28

1111111111111111111111111      1
1P00000000110000000000001111111
1011000001110000000000001   101
1001000000000000000000001   101
1111111110110000011100001   101
100000000011000001110111111110111
1111011111111111110000001000101
1111011111      110101001000101
1100000011 1111 110000000000101
1000000001 1111 110000001000101
1000000001   11 110101001000101
1100000111111111 111011110011011111111111
11110111 110101 1011000100000000000000001
11111111 1111111 111111111111111111111111
