NO ./texture/nosamanz.xpm
SO ./texture/bluestone.xpm
WE ./texture/purplestone.xpm
EA ./texture/impulsive.xpm

F 186,235,52
C 52,171,235

        1111111111111111111111111
        1000000000110000000000001
        10110000011100000N0000001
        1001000000000000000000001
111111111011000001110000000000001
100000000011000001110111111111111
11110111111111111100000010001
11110111111111110000100010011
10000001101010111100000000011
10000000000000000100000010001
10000000000001000101010010001
11000001110101011111011010001
11110111 1110111 100000010001
11111111 1111111 111111111111
