111111111111111
10000000010001
111100000011001
1101111101
1000000000000001
1000000000000001
1111111111111111