1111111111111111
1P00000101000001
1111000000110011
1101111101
10000000000000001
10000000000000001
10000000000000001
11111111111111111
