NO ./texture/redbrick.xpm
SO ./texture/bluestone.xpm
WE ./texture/purplestone.xpm
EA ./texture/greystone.xpm

F 186,235,52
C 52,171,235

    11111111111111111111111111111111111111111
111110000000000000000000000000000000000011
100000000000000000000000000000000000000011
111110000000000000000000000000000000000001
    100000000000000000000000000N0000000011
111110000000000000000000000000000000000011
100000000000000000000000000000000000000011
111110000000000000000000000000000000000001
    10000000000000000000000000000000000001
111110000000000000000000000000000000000011
10000000000000000000000000000000000000001
10000000000000000000000000000000000000001
10000000000000000000000000000000000000001
10000000000000000000000000000000000000001
10000000000000000000000000000000000000001
10000000000000000000000000000000000000001
10000000000000000000000000000000000000001
100000000000000000000000000000000000000001
10000000000000000000000000000000000000001
10000000000000000000000000000000000000001
10000000000000000000000000000000000000001
11111111111111111111111111111111111111111

