


NO ./texture/redbrick.xpm
SO ./texture/bluestone.xpm
WE ./texture/purplestone.xpm
EA ./texture/greystone.xpm

F 186,235,52
C 52,171,235

11111111111111111111111111111111111111111
10111111111000000000000000000000000000001
10101010101000000000000000000000000000001
10101010101000000000000000100000111000001
10101010101101010000000000010001001000001
10000000000010100000000000001010000111111
10000000000000000000000000000100000011111
10000000000000000000000000001010000001111
10000000000000000000000000010010000000111
10000001000000000000000000000001000000011
10000011100000000000000000000000000000001
10000111110000000000000000000000000000001
10000011100000000000000000000000000000001
10000001000000000000000000000000000000001
10000000000000000000000000000000000000001
1000000000000000000000000P000000000000001
10000000000000000000000000000000000000001
10000000000000000000000000000000000000001
10000000000000000000000000000000000000001
10000000000000000000000000000000000000001
10000000000000000000000000000000000000001
11111111111111111111111111111111111111111

