NO ./texture/redbrick.xpm
SO ./texture/bluestone.xpm
WE ./texture/purplestone.xpm
EA ./texture/greystone.xpm

F 186,235,52
C 52,171,235

    11111111111111111111111111111111111111111
111110000000000000000000000000000000000011
100000000000000000000000000000000000000011
111110000000000000000100W000000000000000011111
    100000000000000000000000000000000000000001
1111100000000000000000000000000000000000111111
100000000000000000000000000000000000000011
111110000000000000000000000000000000000001
    10000000000000000000110000000000000011
111110000000000000000000010000000000000011
100000000000000100000000000000000000000011
10000000000000101000000000000000000000001
10000000000000010000000000000000000000001
10000000000000000000000000000000000000001111
10000000010000000000000000000000000000001
10000000001000000000000000000000000000001
100000000000000000000000000000000000000011
100000000000000000000000000000000000000001
100000000000000000000000000000000000000011
11111111111111111111111111111111111111111
10000000000000000000000000000000000000001
10000000000000000000000000000000000000001
11111111111111111111111111111111111111111
