NO ./assets/sprites/wall1.xpm
SO ./assets/sprites/wall2.xpm
WE ./assets/sprites/wall3.xpm
EA ./assets/sprites/wall4.xpm

C 255,146,146
F 138,242,221

111111111111111111111111..................
100000000000000000000001..................
100000000000000000000001..................
100000000000000000000001111111111111111111
100000111110000101010001000000100101110101
100000100001000000000000100000010010101011
100000100001000010001000100000000010111011
100000100001000000000001000000100010101011
100000111100001010100010000000001010101011
100000000000000000000001111111111111111111
100000000000000000000001..................
100000000100000000000001..................
10000000000000000000000111111.............
10000000000000000000001111111.............
100000000000000W0000000111111.............
100000000000000000000001..................
111111111000000000000001..................
110100001000000000000001..................
110000101000000000000001..................
110100001000000000000001..................
110111111000000000000001..................
110000000000000000000001..................
111111111000000000000001..................
111111111111111111111111..................