NO ./assets/sprites/wall1.xpm
SO ./assets/sprites/wall2.xpm
WE ./assets/sprites/wall3.xpm
EA ./assets/sprites/wall4.xpm

C 255,146,146
F 138,242,221

111111111111111111111111....................
100000000000000000000001....................
100000000000000000000001....................
1000......00000000000001111111111111111111..
100000111110000101010001000000100101110101..
10000010000100000000000010000001001010101111
1000001000010000100010001000000000101110111.
100000100001000000000001000000100010101011..
100000111100001010100010000000001010101011..
100000000000000000000001111111111111111111..
100000000000000000000001....................
10..00000100000000000001....................
10000000000000000000000111111...............
10000000000000000000001100001...............
100000000000000W0000000111111...............
100000000000000000000001....................
111111111000000000000001....................
110100001000000000000001....................
110000101000000000000001....................
110100001000000000000001....................
110111111000000000000001....................
110000000000000000000001....................
111111111000000000000001....................
111111111111111111111111..................11