NO ./mandatory/texture/redbrick.xpm
SO ./mandatory/texture/bluestone.xpm
WE ./mandatory/texture/purplestone.xpm
EA ./mandatory/texture/greystone.xpm

F 186,235,52
C 52,171,235

    111111111111111111111111111111111111
111110000000000000000000000000000000000111
100000000000000000000000000000000000000111
11111000000000000000000N00000000000000001111111111
    100000000000000000000000000000000000000001
1111100000000011000000000000000000000000111111
100000000000001100000000000000000000000111
111110000000000000000000000000000000000001
    10000000000000000001110000000000000011
111110000000000000000001010000000000000011
100000000000001110000001110000000000000011
10000000000000101000000000000000000000001
10000000000000111000000000000000000000001
10000000000000000000000000000000000000001111
10000000011000000000000000000000000000001
10000000011000000000000000000000000000001
100000000000000000000000000000000000000011
100000000000000000001111000000000000000001
100000000000000000001  1000000000000000011
100000000000000000001111000000000000000011
100000000000000000000000000000000000000001
100000000000000000000000000000000000000001
111111111111111111111111111111111111111111
